NO ./textures/bluestone.xpm
SO ./textures/wood.xpm
EA ./textures/redbrick.xpm
WE ./textures/greystone.xpm

C 135,206,235

F 127, 127, 127


111111111
1N0000001
100000001
100000001
100000001
100000001
100000001
100000001
100000001
100000001
100000001
100000001
100000001
100000001
100000001
100000001
100000001
100000001
100000001
100000001
100000001
111111111